[
	{
        "name" : "level_1",
        "background_graphics" :"interior",
        "initMap" : [   [ -1, -1, -1, -1, -1, -1, -1, -1, -1, -1, -1, -1, -1, -1, -1, -1, -1, -1, -1, -1, -1, -1, -1, -1, -1, -1, -1],
                        [ -1, -1, -1, -1, -1, -1, -1, -1, -1, -1, -1, -1, -1, -1, -1, -1, -1, -1, -1, -1, -1, -1, -1, -1, -1, -1, -1],
                        [ -1, -1, -1, -1, -1, -1, -1, -1, -1, -1, -1, -1, -1, -1, -1, -1, -1, -1, -1, -1, -1, -1, -1, -1, -1, -1, -1],
                        [ -1, -1, -1, -1, -1, -1,  0, -1, -1,  0,  0,  0,  0,  0,  0, -1,  0,  0,  0,  0, -1, -1, -1, -1, -1, -1, -1],
                        [ -1, -1, -1, -1, -1, -1,  0,  0,  0,  0,  0,  0,  0,  0,  0, -1,  0,  0,  0,  0, -1, -1, -1, -1, -1, -1, -1],
                        [ -1, -1, -1, -1, -1, -1,  0,  0,  0,  0, -1, -1, -1, -1,  0, -1,  0,  0, -1, -1, -1, -1, -1, -1, -1, -1, -1],
                        [ -1, -1, -1, -1, -1, -1,  0,  0,  0,  0, -1, -1, -1, -1,  0, -1,  0, -1, -1, -1, -1, -1, -1, -1, -1, -1, -1],
                        [ -1, -1, -1, -1, -1, -1,  0,  0,  0,  0,  0,  0,  0,  0,  0, -1,  0, -1, -1, -1, -1, -1, -1, -1, -1, -1, -1],
                        [ -1, -1, -1, -1, -1, -1,  0,  0,  0,  0,  0,  0,  0,  0,  0,  0,  0,  0,  0,  0, -1, -1, -1, -1, -1, -1, -1],
                        [ -1, -1, -1, -1, -1, -1,  0,  0,  0,  0,  0,  0,  0,  0,  0,  0,  0,  0,  0,  0, -1, -1, -1, -1, -1, -1, -1],
                        [ -1, -1, -1, -1, -1, -1, -1, -1, -1,  0, -1, -1, -1, -1, -1, -1, -1, -1, -1, -1, -1, -1, -1, -1, -1, -1, -1],
                        [ -1, -1, -1, -1, -1, -1, -1, -1, -1, -1, -1, -1, -1, -1, -1, -1, -1, -1, -1, -1, -1, -1, -1, -1, -1, -1, -1],
                        [ -1, -1, -1, -1, -1, -1, -1, -1, -1, -1, -1, -1, -1, -1, -1, -1, -1, -1, -1, -1, -1, -1, -1, -1, -1, -1, -1],
                        [ -1, -1, -1, -1, -1, -1, -1, -1, -1, -1, -1, -1, -1, -1, -1, -1, -1, -1, -1, -1, -1, -1, -1, -1, -1, -1, -1],
                        [ -1, -1, -1, -1, -1, -1, -1, -1, -1, -1, -1, -1, -1, -1, -1, -1, -1, -1, -1, -1, -1, -1, -1, -1, -1, -1, -1]],
        "gameObjects" : [
            {
            "type" : "Teleportation",
            "graphics" : "teleportation",
            "position" : {
                        "x" : 9,
                        "y" : 4,
                        "layer" : "BACKGROUND"
                    },
            "horizontalHitBox" : 1,
            "verticalHitBox" : 1,
            "nextLevel" : "level_2",
            "nextPosition" : {
                "newX" : 3,
                "newY" : 6
            }
            },
     
            
            {
                "type" : "Chest",
                "graphics" : "chest",
                "position" : {
                            "x" : 19,
                            "y" : 11,
                            "layer" : "BACKGROUND"
                        },
                "horizontalHitBox" : 1,
                "verticalHitBox" : 1
            }
        ]
	},
    {
        "name" : "level_2",
        "background_graphics" :"background_level_1",
        "initMap" : [   [  0,  0,  0,  0,  0,  0,  0,  0,  0,  0,  0,  0,  0,  0,  0,  0,  0,  0,  0,  0,  0,  0,  0,  0,  0,  0,  0],
                        [  0,  0,  0,  0,  0,  0,  0,  0,  0,  0,  0,  0,  0,  0,  0,  0,  0,  0,  0,  0,  0,  0,  0,  0,  0,  0,  0],
                        [  0,  0,  0,  0,  0,  0,  0,  0,  0,  0,  0,  0,  0,  0,  0,  0,  0,  0,  0,  0,  0,  0,  0,  0,  0,  0,  0],
                        [  0,  0,  0,  0,  0,  0,  0,  0,  0,  0,  0,  0,  0,  0,  0,  0,  0,  0,  0,  0,  0,  0,  0,  0,  0,  0,  0],
                        [  0,  0,  0,  0,  0,  0,  0,  0,  0,  0,  0,  0,  0,  0,  0,  0,  0,  0,  0,  0,  0,  0,  0,  0,  0,  0,  0],
                        [  0,  0,  0,  0,  0,  0,  0,  0,  0,  0,  0,  0,  0,  0,  0,  0,  0,  0,  0,  0,  0,  0,  0,  0,  0,  0,  0],
                        [  0, -1, -1, -1, -1, -1, -1, -1,  0,  0,  0,  0,  0,  0,  0,  0,  0,  0,  0,  0,  0,  0,  0,  0,  0,  0,  0],
                        [  0, -1, -1, -1, -1, -1, -1, -1,  0,  0,  0,  0,  0,  0,  0,  0,  0,  0,  0,  0,  0,  0,  0,  0,  0,  0,  0],
                        [  0, -1, -1,  0, -1, -1, -1, -1,  0,  0,  0,  0,  0,  0,  0,  0,  0,  0,  0,  0,  0,  0,  0,  0,  0,  0,  0],
                        [  0,  0,  0,  0,  0,  0,  0,  0,  0,  0,  0,  0,  0,  0,  0,  0,  0,  0,  0,  0,  0,  0,  0,  0,  0,  0,  0],
                        [  0,  0,  0,  0,  0,  0,  0,  0,  0,  0,  0,  0,  0,  0,  0,  0,  0,  0,  0,  0,  0,  0,  0,  0,  0,  0,  0],
                        [  0,  0,  0,  0,  0,  0,  0,  0,  0,  0,  0,  0,  0,  0,  0,  0,  0,  0,  0,  0,  0,  0,  0,  0,  0,  0,  0],
                        [  0,  0,  0,  0,  0,  0,  0,  0,  0,  0,  0,  0,  0,  0,  0,  0,  0,  0,  0,  0,  0,  0,  0,  0,  0,  0,  0],
                        [ -1, -1, -1, -1, -1, -1, -1, -1, -1, -1, -1, -1, -1, -1, -1, -1, -1, -1, -1, -1, -1, -1, -1, -1, -1, -1, -1],
                        [ -1, -1, -1, -1, -1, -1, -1, -1, -1, -1, -1, -1, -1, -1, -1, -1, -1, -1, -1, -1, -1, -1, -1, -1, -1, -1, -1]],
        "gameObjects" : [
            {
            "type" : "GameObject",
            "graphics" : "house",
            "position" : {
                        "x" : 0,
                        "y" : 6,
                        "layer" : "BACKGROUND"
                    }

            },
            {
            "type" : "Door",
            "graphics" : "door",
            "position" : {
                        "x" : 3,
                        "y" : 6,
                        "layer" : "BACKGROUND"
                    },

            "horizontalHitBox" : 1,
            "verticalHitBox" : 1,
            "nextLevel" : "level_1",
            "nextPosition" : {
                "newX" : 9,
                "newY" : 5
            }
            },
     
            {
            "type" : "Chest",
            "graphics" : "chest",
            "position" : {
                        "x" : 17,
                        "y" : 8,
                        "layer" : "BACKGROUND"
                    },
            "horizontalHitBox" : 1,
            "verticalHitBox" : 1
            },
            {
            "type" : "Ladder",
            "graphics" : "ladder",
            "position" : {
                        "x" : 8,
                        "y" : 5,
                        "layer" : "BACKGROUND"
                    },
            "horizontalHitBox" : 1,
            "verticalHitBox" : 3
            },
            {
            "type" : "Trap",
            "graphics" : "stupidTrap",
            "position" : {
                        "x" : 26,
                        "y" : 14,
                        "layer" : "BACKGROUND"
                    },
            "horizontalHitBox" : 1,
            "verticalHitBox" : 1,
            "dammage" : 15
            },
            {
            "type" : "TrappedBox",
            "graphics" : "box",
            "position" : {
                        "x" : 20,
                        "y" : 5,
                        "layer" : "BACKGROUND"
                    },
            "horizontalHitBox" : 1,
            "verticalHitBox" : 1
            }
        ]
	}
]
