[
	{
        "name" : "level_1",
        "background_graphics" :"interior",
        "initMap" : [   [ -1, -1, -1, -1, -1, -1, -1, -1, -1, -1, -1, -1, -1, -1, -1, -1, -1, -1, -1, -1, -1, -1, -1, -1, -1, -1, -1],
                        [ -1, -1, -1, -1, -1, -1, -1, -1, -1, -1, -1, -1, -1, -1, -1, -1, -1, -1, -1, -1, -1, -1, -1, -1, -1, -1, -1],
                        [ -1, -1, -1, -1, -1, -1, -1, -1, -1, -1, -1, -1, -1, -1, -1, -1, -1, -1, -1, -1, -1, -1, -1, -1, -1, -1, -1],
                        [ -1, -1, -1, -1, -1, -1,  0, -1, -1,  0,  0,  0,  0,  0,  0, -1,  0,  0,  0,  0, -1, -1, -1, -1, -1, -1, -1],
                        [ -1, -1, -1, -1, -1, -1,  0,  0,  0,  0,  0,  0,  0,  0,  0, -1,  0,  0,  0,  0, -1, -1, -1, -1, -1, -1, -1],
                        [ -1, -1, -1, -1, -1, -1,  0,  0,  0,  0, -1, -1, -1, -1,  0, -1,  0,  0, -1, -1, -1, -1, -1, -1, -1, -1, -1],
                        [ -1, -1, -1, -1, -1, -1,  0,  0,  0,  0, -1, -1, -1, -1,  0, -1,  0, -1, -1, -1, -1, -1, -1, -1, -1, -1, -1],
                        [ -1, -1, -1, -1, -1, -1,  0,  0,  0,  0,  0,  0,  0,  0,  0, -1,  0, -1, -1, -1, -1, -1, -1, -1, -1, -1, -1],
                        [ -1, -1, -1, -1, -1, -1,  0,  0,  0,  0,  0,  0,  0,  0,  0,  0,  0,  0,  0,  0, -1, -1, -1, -1, -1, -1, -1],
                        [ -1, -1, -1, -1, -1, -1,  0,  0,  0,  0,  0,  0,  0,  0,  0,  0,  0,  0,  0,  0, -1, -1, -1, -1, -1, -1, -1],
                        [ -1, -1, -1, -1, -1, -1, -1, -1, -1,  0, -1, -1, -1, -1, -1, -1, -1, -1, -1, -1, -1, -1, -1, -1, -1, -1, -1],
                        [ -1, -1, -1, -1, -1, -1, -1, -1, -1, -1, -1, -1, -1, -1, -1, -1, -1, -1, -1, -1, -1, -1, -1, -1, -1, -1, -1],
                        [ -1, -1, -1, -1, -1, -1, -1, -1, -1, -1, -1, -1, -1, -1, -1, -1, -1, -1, -1, -1, -1, -1, -1, -1, -1, -1, -1],
                        [ -1, -1, -1, -1, -1, -1, -1, -1, -1, -1, -1, -1, -1, -1, -1, -1, -1, -1, -1, -1, -1, -1, -1, -1, -1, -1, -1],
                        [ -1, -1, -1, -1, -1, -1, -1, -1, -1, -1, -1, -1, -1, -1, -1, -1, -1, -1, -1, -1, -1, -1, -1, -1, -1, -1, -1]],
        "gameObjects" : [
            {
            "type" : "Teleportation",
            "graphics" : "teleportation",
            "position" : {
                        "x" : 9,
                        "y" : 4,
                        "layer" : "BACKGROUND"
                    },
            "horizontalHitBox" : 1,
            "verticalHitBox" : 1,
            "nextLevel" : "level_2",    
            "nextPosition" : {
                "newX" : 3,
                "newY" : 6
            }
            },
     
            
            {
                "type" : "Chest",
                "graphics" : "chest",
                "position" : {
                            "x" : 19,
                            "y" : 11,
                            "layer" : "BACKGROUND"
                        },
                "horizontalHitBox" : 1,
                "verticalHitBox" : 1
            }
        ]
	},
    {
        "name" : "level_2",
        "background_graphics" :"background_level_1",
        "initMap" : [   [  0,  0,  0,  0,  0,  0, -1, -1, -1, -1, -1, -1, -1, -1, -1, -1, -1, -1, -1,  0,  0,  0,  0,  0,  0,  0,  0],
                        [  0,  0,  0,  0,  0,  0, -1, -1, -1, -1, -1, -1, -1,  0, -1, -1, -1, -1, -1,  0,  0,  0,  0,  0,  0,  0,  0],
                        [  0,  0,  0,  0,  0,  0, -1, -1, -1,  0,  0,  0, -1,  0, -1,  0,  0,  0,  0,  0,  0,  0,  0,  0,  0,  0,  0],
                        [  0,  0,  0,  0,  0,  0, -1, -1, -1,  0,  0,  0, -1,  0, -1,  0,  0,  0,  0,  0,  0,  0,  0,  0,  0,  0,  0],
                        [  0,  0,  0,  0,  0,  0,  0,  0,  0,  0,  0,  0, -1,  0,  0,  0,  0,  0,  0,  0,  0,  0,  0,  0,  0,  0,  0],
                        [  0,  0,  0,  0,  0,  0,  0,  0,  0,  0,  0,  0,  0,  0,  0,  0,  0,  0,  0,  0,  0,  0,  0,  0,  0,  0,  0],
                        [  0, -1, -1, -1, -1, -1, -1, -1,  0,  0,  0,  0,  0,  0,  0,  0,  0,  0, -1,  0,  0,  0, -1,  0,  0,  0,  0],
                        [  0, -1, -1, -1, -1, -1, -1, -1,  0,  0,  0,  0,  0,  0,  0,  0,  0,  0, -1,  0,  0,  0, -1,  0,  0,  0,  0],
                        [  0, -1, -1,  0, -1, -1, -1, -1,  0,  0,  0,  0,  0,  0,  0,  0,  0,  0, -1,  0,  0,  0, -1,  0,  0,  0,  0],
                        [  0,  0,  0,  0,  0,  0,  0,  0,  0,  0,  0,  0,  0,  0,  0,  0,  0,  0, -1, -1,  0, -1, -1,  0,  0,  0,  0],
                        [  0,  0,  0,  0,  0,  0,  0,  0,  0,  0,  0,  0,  0,  0,  0,  0,  0,  0, -1, -1,  0, -1, -1,  0,  0,  0,  0],
                        [  0,  0,  0,  0,  0,  0,  0,  0,  0,  0,  0,  0,  0,  0,  0,  0,  0,  0,  0,  0,  0,  0,  0,  0,  0,  0,  0],
                        [  0,  0,  0,  0,  0,  0,  0,  0,  0,  0,  0,  0,  0,  0,  0,  0,  0,  0,  0,  0,  0,  0,  0,  0,  0,  0,  0],
                        [ -1, -1, -1, -1, -1, -1, -1, -1, -1, -1, -1, -1, -1, -1, -1, -1, -1, -1, -1, -1, -1, -1, -1, -1, -1, -1, -1],
                        [ -1, -1, -1, -1, -1, -1, -1, -1, -1, -1, -1, -1, -1, -1, -1, -1, -1, -1, -1, -1, -1, -1, -1, -1, -1, -1, -1]],
        "gameObjects" : [
            {
            "type" : "GameObject",
            "graphics" : "house",
            "position" : {
                        "x" : 0,
                        "y" : 6,
                        "layer" : "BACKGROUND"
                    }

            },
            {
            "type" : "Door",
            "graphics" : "door",
            "position" : {
                        "x" : 3,
                        "y" : 6,
                        "layer" : "BACKGROUND"
                    },

            "horizontalHitBox" : 1,
            "verticalHitBox" : 1,
            "nextLevel" : "level_1",
            "nextPosition" : {
                "newX" : 9,
                "newY" : 5
                }
            },
            {
            "type" : "Door",
            "graphics" : "door_2",
            "position" : {
                        "x" : 13,
                        "y" : 13,
                        "layer" : "BACKGROUND"
                    },

            "horizontalHitBox" : 1,
            "verticalHitBox" : 1,
            "nextLevel" : "level_4",
            "nextPosition" : {
                "newX" : 13,
                "newY" : 4
                }
            },
            {
            "type" : "Chest",
            "graphics" : "chest",
            "position" : {
                        "x" : 20,
                        "y" : 8,
                        "layer" : "BACKGROUND"
                    },
            "horizontalHitBox" : 1,
            "verticalHitBox" : 1
            },
            {
            "type" : "Ladder",
            "graphics" : "ladder",
            "position" : {
                        "x" : 20,
                        "y" : 4,
                        "layer" : "BACKGROUND"
                    },
            "horizontalHitBox" : 1,
            "verticalHitBox" : 2
            },
            {
            "type" : "GameObject",
            "graphics" : "tree_1",
            "position" : {
                        "x" : 19,
                        "y" : 8,
                        "layer" : "BACKGROUND"
                    },
            "horizontalHitBox" : 1,
            "verticalHitBox" : 1
            },
            {
            "type" : "GameObject",
            "graphics" : "tree_1",
            "position" : {
                        "x" : 21,
                        "y" : 8,
                        "layer" : "BACKGROUND"
                    },
            "horizontalHitBox" : 1,
            "verticalHitBox" : 1
            },
            {
            "type" : "Trap",
            "graphics" : "stupidTrap",
            "position" : {
                        "x" : 26,
                        "y" : 14,
                        "layer" : "BACKGROUND"
                    },
            "horizontalHitBox" : 1,
            "verticalHitBox" : 1,
            "dammage" : 15
            }
        ]
	},
    {
        "name" : "level_3",
        "background_graphics" :"interior",
        "initMap" : [   [ -1, -1, -1, -1, -1, -1, -1, -1, -1, -1, -1, -1, -1, -1, -1, -1, -1, -1, -1, -1, -1, -1, -1, -1, -1, -1, -1],
                        [ -1, -1, -1, -1, -1, -1, -1, -1, -1, -1, -1, -1, -1, -1, -1, -1, -1, -1, -1, -1, -1, -1, -1, -1, -1, -1, -1],
                        [ -1, -1, -1, -1, -1, -1, -1, -1, -1, -1, -1, -1, -1, -1, -1, -1, -1, -1, -1, -1, -1, -1, -1, -1, -1, -1, -1],
                        [ -1, -1, -1, -1, -1, -1,  0, -1, -1,  0,  0,  0,  0,  0,  0, -1,  0,  0,  0,  0, -1, -1, -1, -1, -1, -1, -1],
                        [ -1, -1, -1, -1, -1, -1,  0,  0,  0,  0,  0,  0,  0,  0,  0, -1,  0,  0,  0,  0, -1, -1, -1, -1, -1, -1, -1],
                        [ -1, -1, -1, -1, -1, -1,  0,  0,  0,  0, -1, -1, -1, -1,  0, -1,  0,  0, -1, -1, -1, -1, -1, -1, -1, -1, -1],
                        [ -1, -1, -1, -1, -1, -1,  0,  0,  0,  0, -1, -1, -1, -1,  0, -1,  0, -1, -1, -1, -1, -1, -1, -1, -1, -1, -1],
                        [ -1, -1, -1, -1, -1, -1,  0,  0,  0,  0,  0,  0,  0,  0,  0, -1,  0, -1, -1, -1, -1, -1, -1, -1, -1, -1, -1],
                        [ -1, -1, -1, -1, -1, -1,  0,  0,  0,  0,  0,  0,  0,  0,  0,  0,  0,  0,  0,  0, -1, -1, -1, -1, -1, -1, -1],
                        [ -1, -1, -1, -1, -1, -1,  0,  0,  0,  0,  0,  0,  0,  0,  0,  0,  0,  0,  0,  0, -1, -1, -1, -1, -1, -1, -1],
                        [ -1, -1, -1, -1, -1, -1, -1, -1, -1,  0, -1, -1, -1, -1, -1, -1, -1, -1, -1, -1, -1, -1, -1, -1, -1, -1, -1],
                        [ -1, -1, -1, -1, -1, -1, -1, -1, -1, -1, -1, -1, -1, -1, -1, -1, -1, -1, -1, -1, -1, -1, -1, -1, -1, -1, -1],
                        [ -1, -1, -1, -1, -1, -1, -1, -1, -1, -1, -1, -1, -1, -1, -1, -1, -1, -1, -1, -1, -1, -1, -1, -1, -1, -1, -1],
                        [ -1, -1, -1, -1, -1, -1, -1, -1, -1, -1, -1, -1, -1, -1, -1, -1, -1, -1, -1, -1, -1, -1, -1, -1, -1, -1, -1],
                        [ -1, -1, -1, -1, -1, -1, -1, -1, -1, -1, -1, -1, -1, -1, -1, -1, -1, -1, -1, -1, -1, -1, -1, -1, -1, -1, -1]],
        "gameObjects" : [
            {
            "type" : "Teleportation",
            "graphics" : "teleportation",
            "position" : {
                        "x" : 9,
                        "y" : 4,
                        "layer" : "BACKGROUND"
                    },
            "horizontalHitBox" : 1,
            "verticalHitBox" : 1,
            "nextLevel" : "level_2",    
            "nextPosition" : {
                "newX" : 13,
                "newY" : 13
            }
            },
     
            
            {
                "type" : "Chest",
                "graphics" : "chest",
                "position" : {
                            "x" : 19,
                            "y" : 11,
                            "layer" : "BACKGROUND"
                        },
                "horizontalHitBox" : 1,
                "verticalHitBox" : 1
            }
        ]
	},
    {
        "name" : "level_4",
        "background_graphics" :"salleBoss",
        "initMap" : [   [ -1, -1, -1, -1, -1, -1, -1, -1, -1, -1, -1, -1, -1, -1, -1, -1, -1, -1, -1, -1, -1, -1, -1, -1, -1, -1, -1],
                        [ -1, -1, -1, -1, -1, -1, -1, -1, -1, -1,  0,  0,  0, -1, -1, -1, -1, -1, -1, -1, -1, -1, -1, -1, -1, -1, -1],
                        [ -1, -1, -1, -1, -1, -1, -1, -1, -1, -1, -1, -1, -1, -1, -1, -1, -1, -1, -1, -1, -1, -1, -1, -1, -1, -1, -1],
                        [ -1, -1, -1, -1, -1, -1, -1, -1, -1, -1,  0 , 0,  0, -1,  0,  0,  0,  0,  0, -1, -1, -1, -1, -1, -1, -1, -1],
                        [ -1, -1, -1, -1, -1, -1, -1, -1, -1,  0, -1,  0,  0,  0,  0,  0, -1,  0, -1, -1, -1, -1, -1, -1, -1, -1, -1],
                        [ -1, -1, -1, -1, -1, -1, -1, -1, -1,  0, -1,  0,  0,  0,  0,  0,  0,  0, -1,  0,  0, -1, -1, -1, -1, -1, -1],
                        [ -1, -1, -1, -1, -1, -1, -1, -1, -1,  0,  0,  0,  0,  0,  0,  0,  0,  0,  0,  0,  0, -1, -1, -1, -1, -1, -1],
                        [ -1, -1, -1, -1, -1, -1, -1,  0,  0,  0,  0, -1,  0,  0,  0,  0, -1,  0, -1, -1, -1, -1, -1, -1, -1, -1, -1],
                        [ -1, -1, -1, -1, -1, -1, -1,  0,  0,  0,  0, -1,  0,  0,  0,  0, -1,  0, -1, -1, -1, -1, -1, -1, -1, -1, -1],
                        [ -1, -1, -1, -1, -1, -1, -1, -1, -1,  0,  0,  0,  0,  0,  0,  0,  0,  0, -1, -1, -1, -1, -1, -1, -1, -1, -1],
                        [ -1, -1, -1, -1, -1, -1, -1, -1, -1, -1, -1, -1, -1,  0, -1, -1, -1, -1, -1, -1, -1, -1, -1, -1, -1, -1, -1],
                        [ -1, -1, -1, -1, -1, -1, -1, -1, -1, -1, -1, -1, -1,  0, -1, -1, -1, -1, -1, -1, -1, -1, -1, -1, -1, -1, -1],
                        [ -1, -1, -1, -1, -1, -1, -1, -1, -1, -1, -1, -1, -1,  0, -1, -1, -1, -1, -1, -1, -1, -1, -1, -1, -1, -1, -1],
                        [ -1, -1, -1, -1, -1, -1, -1, -1, -1, -1, -1, -1, -1, -1, -1, -1, -1, -1, -1, -1, -1, -1, -1, -1, -1, -1, -1],
                        [ -1, -1, -1, -1, -1, -1, -1, -1, -1, -1, -1, -1, -1, -1, -1, -1, -1, -1, -1, -1, -1, -1, -1, -1, -1, -1, -1]],
        "gameObjects" : [     
            {
                "type" : "Chest",
                "graphics" : "chest",
                "position" : {
                            "x" : 20,
                            "y" : 9,
                            "layer" : "BACKGROUND"
                        },
                "horizontalHitBox" : 1,
                "verticalHitBox" : 1
            },
            {
                "type" : "Teleportation",
                "graphics" : "teleportation",
                "position" : {
                            "x" : 13,
                            "y" : 3,
                            "layer" : "BACKGROUND"
                        },
                "horizontalHitBox" : 1,
                "verticalHitBox" : 1,
                "nextLevel" : "level_2",    
                "nextPosition" : {
                    "newX" : 13,
                    "newY" : 13
                }
            }
        ]
	}
]
